0,0,0,0,0,791,792,793,794,795,796,791,792,793,794,795,796,0,0,0,0,0,0,0,0,0
0,0,0,0,0,821,822,823,824,825,826,821,822,823,824,825,826,0,0,0,0,0,0,0,0,0
0,0,0,0,0,851,852,853,854,855,856,851,852,853,854,855,856,0,0,0,0,0,0,0,0,0
0,0,0,0,0,881,882,883,884,885,886,881,882,883,884,885,886,0,0,0,0,0,0,0,0,0
0,0,0,0,0,911,912,913,914,915,916,911,912,913,914,915,916,0,0,0,0,0,0,0,0,0
0,0,0,0,0,859,860,943,944,945,946,0,0,943,944,945,946,0,0,859,860,0,83,83,83,83
0,0,0,0,0,889,890,973,974,305,306,0,0,973,974,305,306,0,0,889,890,0,82,82,82,82
0,0,0,0,0,20,20,21,0,0,0,0,0,0,0,0,0,0,0,0,0,0,0,0,0,0
