0,0,0,0,0,0,0,0,0,0,0,0,0,0,0,0,0,0,0,0,0,0,0,416,417,418,419,420,421,422,423,424,0,0,0,0,0,0,0,0,0,0,0,0,0,0,0,0,0,0,0,0,0,0,0,0,0,0,0,0,0,0,0,0,0,0,0,0,0,0,0,0,0,0,0,648,649,650,651,652,653,654,655,656,657,658,659,0,0,0,0,0,0,0,0,0,0,0,0,0,0,0,0,0,0,0,0,407,408,409,410,411,412,413,414,415,416,417,418,419,420,421,422,423,424,0,0,0,0,0,0,0,0,0,0,0,0,0,0,0,0,0,0,0,0,0,0,0,0,0,0,0,0,0,0,0,0,0,0,0,0,0,0,0,0,0,0,0,0,0,0,0,648,649,650,651,652,653,654,655,656,657,658,659,0,0,0,0,0,0,0,0,0,0,0,0,0,0,0,257,258,259,260,261,262,263,264,0,0,0,0,0,0,0,0,0,0,0,0,0,0,0,0,0,0,0,0,0,0,0,0,0,0,0,0,0,0,0,0,0,0,0,0,0,0,0,0,0,791,792,793,794,795,796,0
0,4,2,2,2,2,2,3,0,0,0,0,0,0,0,0,0,0,0,0,0,0,0,446,447,448,449,450,451,452,453,454,0,0,0,0,0,0,0,0,0,0,0,0,265,266,267,268,269,270,271,272,0,0,0,0,0,0,0,0,0,0,0,0,0,0,0,0,0,0,0,0,0,0,0,678,679,680,681,682,683,684,685,686,687,688,689,0,0,0,0,0,0,0,0,0,0,0,0,0,0,0,0,0,0,0,0,437,438,439,440,441,442,443,444,445,446,447,448,449,450,451,452,453,454,0,0,0,0,0,0,0,0,0,0,0,0,0,0,0,0,0,0,0,0,0,0,0,0,0,0,0,0,0,0,0,0,0,576,0,0,0,0,0,0,576,0,0,0,0,0,0,678,679,680,681,682,683,684,685,686,687,688,689,0,0,0,0,0,0,0,0,0,0,0,0,0,0,0,287,288,289,290,291,292,293,294,0,0,0,0,0,0,0,0,,0,61,53,53,54,0,0,0,0,0,0,0,0,0,0,0,0,0,0,0,0,0,0,0,0,0,0,0,0,0,0,0,821,822,823,824,825,826,0
0,13,11,11,11,11,11,12,0,0,0,0,0,0,0,0,0,0,0,0,0,0,0,476,477,478,479,480,481,482,483,484,0,0,0,0,0,0,0,0,0,0,0,0,295,296,297,298,299,300,301,302,0,0,0,0,0,0,0,0,0,0,0,0,0,0,0,0,0,0,0,0,0,0,0,708,709,710,711,712,713,714,715,716,717,718,719,0,0,0,0,0,0,0,0,0,0,0,0,0,0,0,0,0,0,0,0,467,468,469,470,471,472,473,474,475,476,477,478,479,480,481,482,483,484,0,0,0,0,0,0,0,0,0,0,0,0,0,0,0,0,0,0,0,0,0,0,0,0,0,576,0,0,0,0,0,0,0,0,0,0,0,0,0,0,0,0,0,0,0,0,0,708,709,710,711,712,713,714,715,716,717,718,719,0,0,0,0,0,0,0,0,0,0,0,0,0,0,0,317,318,319,320,321,322,323,324,0,0,0,0,0,0,0,0,0,0,61,62,62,63,0,0,0,0,0,0,0,0,0,0,0,0,0,0,0,0,0,0,0,0,0,0,0,0,0,0,0,851,852,853,854,855,856,0
0,10,11,11,11,11,11,12,0,0,0,0,0,0,0,0,0,0,0,0,0,0,0,506,507,508,509,510,511,512,513,514,0,0,0,0,0,0,0,0,0,0,0,0,325,326,327,328,329,330,331,332,0,0,0,0,0,0,0,0,0,0,0,0,0,0,0,0,0,0,0,0,0,0,0,738,739,740,741,742,743,744,745,746,747,748,749,0,0,0,0,0,0,0,0,0,0,0,0,0,0,0,0,0,0,0,0,497,498,499,500,501,502,503,504,505,506,507,508,509,510,511,512,513,514,0,0,0,0,0,0,0,0,0,0,0,0,0,0,0,0,0,0,0,0,0,0,0,0,0,0,0,0,0,0,0,0,0,0,0,0,0,0,0,0,0,0,0,0,0,0,0,738,739,740,741,742,743,744,745,746,747,748,749,0,0,0,0,0,0,0,0,0,0,0,0,0,0,0,347,348,349,350,351,352,353,354,0,0,0,0,0,0,0,0,0,0,52,53,53,53,53,54,0,,0,813,0,0,0,0,0,0,0,0,0,0,0,0,0,0,0,0,0,0,0,0,0,881,882,883,884,885,886,0
0,10,11,11,11,11,11,12,0,0,0,0,0,0,0,0,0,0,0,0,0,0,0,536,537,538,539,540,541,542,543,544,0,0,0,0,0,0,0,0,0,0,1117,0,355,356,357,358,359,360,361,362,0,0,0,0,0,0,0,0,0,0,0,0,0,0,0,0,0,0,0,0,0,0,0,768,769,770,771,772,773,774,775,776,777,778,779,0,0,0,0,0,0,0,0,0,0,0,0,0,0,0,0,0,0,0,0,527,528,529,530,531,532,533,534,535,536,537,538,539,540,541,542,543,544,0,0,0,0,0,0,0,0,0,0,0,0,0,0,0,0,0,0,0,0,0,0,10,11,11,11,11,11,11,11,11,12,10,11,11,11,11,11,12,10,11,11,11,11,11,12,0,768,769,770,771,772,773,774,775,776,777,778,779,0,0,0,0,0,0,0,0,0,0,0,0,0,0,0,527,528,529,530,531,532,533,534,0,0,0,0,0,0,0,0,0,0,61,62,62,62,62,63,0,841,842,843,0,0,0,0,0,0,0,0,0,0,0,0,0,0,0,0,0,0,0,0,0,911,912,913,914,915,916,0
2,22,11,11,11,11,11,12,0,0,0,0,0,0,0,0,83,83,83,83,83,83,83,566,567,568,569,570,571,572,573,574,83,83,83,83,0,0,0,0,0,0,0,0,0,0,0,0,0,0,0,0,0,0,0,0,0,635,0,0,0,0,0,0,0,0,0,0,0,0,0,0,0,0,0,798,799,800,801,802,803,804,805,806,807,808,809,863,0,0,0,0,0,0,0,0,0,0,0,0,0,0,0,637,638,639,640,557,558,559,560,561,562,563,564,565,566,567,568,569,570,571,572,573,574,861,862,857,858,0,0,0,0,0,0,0,0,0,0,0,0,0,0,0,0,0,0,10,11,11,11,11,11,11,11,11,12,10,11,11,11,11,11,12,10,11,11,11,11,11,12,0,798,799,800,801,802,803,804,805,806,807,808,809,695,696,695,696,695,696,695,696,696,695,696,695,696,695,696,557,558,559,560,561,562,563,564,325,326,327,328,329,330,331,332,,52,53,53,53,53,53,54,0,871,0,0,0,0,0,0,0,0,0,0,0,0,0,0,0,0,0,0,0,0,0,0,0,859,860,943,944,945,946,0
11,11,11,11,11,11,11,12,0,0,0,0,1117,0,0,0,82,82,82,82,82,82,82,596,597,598,599,600,601,602,603,604,82,82,82,82,0,0,0,0,0,0,0,0,0,0,0,0,0,0,0,0,0,0,0,0,0,0,0,0,0,0,0,0,0,0,0,0,0,0,0,0,0,1117,0,828,829,830,831,832,833,834,835,836,837,838,839,893,0,37,38,38,38,38,38,38,39,0,0,0,0,0,0,667,668,669,670,587,588,589,590,591,592,593,594,595,596,597,598,599,600,601,602,603,604,891,892,887,888,0,0,0,0,0,1117,0,0,0,0,0,0,0,0,0,0,0,0,10,11,11,11,11,11,11,11,11,12,10,11,11,11,11,11,12,10,11,11,11,11,11,12,1117,828,829,830,831,832,833,834,835,836,837,838,839,725,726,725,726,725,726,725,726,726,725,726,725,726,725,726,587,588,589,590,591,592,593,594,355,356,357,358,359,360,361,362,,61,62,62,62,62,62,63,0,901,0,0,0,0,0,0,0,0,0,0,0,0,0,0,0,0,0,0,0,0,0,0,0,889,890,973,974,305,306,0
20,20,20,20,20,20,20,21,0,0,0,0,0,0,0,0,0,0,0,0,0,0,0,0,0,0,0,0,0,0,0,0,0,0,0,0,0,0,0,0,0,0,0,0,0,0,0,0,0,0,0,0,0,0,0,0,0,0,0,0,0,0,0,0,0,0,0,0,0,0,0,0,0,0,0,0,0,0,0,0,0,0,0,0,0,0,0,0,0,0,0,0,0,0,0,0,0,0,148,148,148,0,0,0,0,0,0,0,0,0,0,0,0,0,0,0,0,0,0,0,0,0,0,0,0,0,0,0,0,0,0,148,148,148,0,0,0,0,0,0,0,0,0,0,0,0,0,0,0,0,0,0,0,0,0,0,0,0,0,0,0,0,0,0,0,0,0,0,0,0,0,0,0,0,0,0,0,0,0,0,0,0,0,0,0,0,0,0,0,0,0,0,0,0,0,0,0,0,0,0,0,0,0,0,0,0,0,0,0,0,0,0,0,0,0,0,0,0,0,0,0,0,0,0,0,0,0,0,0,0,0,0,0,0,0,0,0,0,0,0,0,0,0,0,0,0,0,0,0,0,0,0,0,0,0
